#####
#   #
#@R #
#.  #
#   #
###L#